Fernando Melo da Costa	PT
Flaviano Flávio Baptista de Melo	PMDB
Gladson de Lima Cameli	PP
Henrique Afonso Soares Lima	PT
Ilderlei Sousa Rodrigues Cordeiro	PPS
Nilson Moura Leite Mourão	PT
Maria Perpétua Almeida	PCdoB
Sérgio de Oliveira Cunha	PMN
Benedito de Lira	PP
Carlos Alberto Moreira de Mendonça Canuto	PMDB
Antônio Carlos Chamariz	PTB
José Francisco Cerqueira Tenório	PMN
Augusto Farias	PTB
Givaldo de Sá Gouveia Carimbão	PSB
Joaquim Beltrão Siqueira	PMDB
Maurício Quintella Malta Lessa	PR
Olavo Calheiros Filho	PMDB
Maria Dalva de Sousa Figueiredo	PT
David Samuel Alcolumbre Tobelem	DEM
Evandro Costa Milhomen	PCdoB
Fátima Lúcia Pelaes	PMDB
Janete Maria Góes Capiberibe	PSB
Jurandil dos Santos Juarez	PMDB
Maria Lucenira Ferreira Oliveira Pimentel	PR
Sebastião Ferreira da Rocha	PDT
Atila Sidney Lins Albuquerque	PMDB
Carlos Alberto Cavalcante de Sousa	PRB
Marcelo Augusto da Eira Correa	PSB
Francisco Ednaldo Praciano	PT
Rebecca Martins Garcia	PP
Raimundo Sabino Castelo Branco Maués	PTB
Silas Câmara	PSC
Vanessa Grazziotin	PCdoB
Alice Mazzuco Portugal	PCdoB
Antônio Carlos Peixoto de Magalhães Neto	DEM
Claudio Cajado Sampaio	DEM
Colbert Martins da Silva Filho	PMDB
Daniel Gomes de Almeida	PCdoB
Edson Gonçalves Duarte	PV
Fábio Loureiro Souto	DEM
Felix de Almeida Mendonça	DEM
Luís Fernando de Fabinho Araújo Lima	DEM
Edigar Evangelista dos Anjos	PV
Geddel Vieira Lima	PMDB
Guilherme Menezes de Andrade	PT
João Almeida dos Santos	PSDB
João Carlos Paolilo Bacelar Filho	PR
João Felipe de Sousa Leão	PP
Jorge Khoury Hedaye	DEM
José Carlos Aleluia Costa	DEM
José Carlos Leão de Araújo	PR
José Alves Rocha	DEM
Joseph Wallace Faria Bandeira	PT
Jusmari Terezinha de Sousa Oliveira	PR
Jutahy Magalhães Júnior	PSDB
Lídice da Mata e Sousa	PSB
Luís Carlos Bassuma	PT
Luís Antônio Vasconcelos Carreira	DEM
Marcelo de Oliveira Guimarães Filho	DEM
Marcos Antônio Medrado	PDT
Mário Silvio Mendes Negromonte	PP
Maurício Gonçalves Trindade	PR
Nelson Vicente Portela Pellegrino	PT
Paulo Sergio Paranhos de Magalhaes	DEM
Roberto Pereira de Britto	PP
Sérgio Barradas Carneiro	PT
Sergio Luis Lacerda Brito	PMDB
Severiano Alves de Sousa	PDT
Antônia Magalhães da Cruz	DEM
Uldurico Alves Pinto	PMN
Raymundo Veloso Silva	PMDB
Walter de Freitas Pinheiro	PT
José Eduardo Vieira Ribeiro	PT
Aníbal Ferreira Gomes	PMDB
Francisco Ariosto Holanda	PSB
José Arnon Cruz Bezerra de Menezes	PTB
Francisco Lopes da Silva	PCdoB
Antônio Eudes Xavier	PT
Eugênio Rabelo	PP
Eunício Lopes de Oliveira	PMDB
Flávio Bezerra da Silva	PMDB
Maria Gorete Pereira	PR
José Airton Félix Cirilo da Silva	PT
José Nobre Guimarães	PT
José Linhares Ponte	PP
José Barroso Pimentel	PT
Leonardo Rosario de Alcântara	PSDB
Manoel Salviano Sobrinho	PSDB
Antônio Marcelo Teixeira Sousa	PSDB
Carlos Mauro Cabral Benevides	PMDB
Paulo Henrique Ellery Lustosa da Costa	PMDB
Raimundo Gomes de Matos	PSDB
Vicente Ferreira de Arruda Coelho	PSDB
José Gerardo Oliveira de Arruda Filho	PMDB
Osório Adriano Filho	DEM
Augusto Silveira de Carvalho	PPS
Jofran Frejat	PR
Laerte Rodrigues de Bessa	PMDB
Geraldo Magela Pereira	PT
Robson Lemos Rodovalho	DEM
Rodrigo Sobral Rollemberg	PSB
Nelson Tadeu Filippelli	PMDB
Camilo Cola	PMDB
Iriny Nicolau Corres Lopes	PT
Jurandyr Loureiro Barroso	PAN
Welington Coimbra	PMDB
Luís Paulo Veloso Lucas	PSDB
Carlos Humberto Mannato	PDT
Lucínio Castelo de Assunção	PSB
Rita de Cássia Paste Camata	PSDB
Rosilda de Freitas	PMDB
Sueli Rangel Silva Vidigal	PDT
Carlos Alberto Leréia da Silva	PSDB
Iris de Araujo Rezende Machado	PMDB
João Campos de Araújo	PSDB
Jovair de Oliveira Arantes	PTB
Leandro Vilela Veloso	PMDB
Leonardo Moura Vilela	PSDB
Luís José Bittencourt	PMDB
Marcelo de Araújo Melo	PMDB
Pedro Pinheiro Chaves	PMDB
Pedro Wilson Guimarães	PT
Raquel Figueiredo Alessandri Teixeira	PSDB
Francisco Gomes de Abreu	PP
Ronaldo Ramos Caiado	DEM
Rubens Otoni Gomide	PT
João Sandes Júnior	PP
Sandro Antônio Mabel Scodro	PR
José Fuscaldi Cesilio	PTB
Carlos Orleans Brandão Junior	PSDB
Cleber Verde Cordeiro Mendes	PAN
Clóvis Antônio Chaves Fecury	DEM
Davi Alves Silva Júnior	PR
Domingos Francisco Dutra Filho	PT
Flávio Dino de Castro e Costa	PCdoB
Gastão Dias Vieira	PMDB
Julião Amin Castro	PDT
Nice Lobão	DEM
Pedro Fernandes Ribeiro	PTB
Pedro Novais Lima	PMDB
José Eleonildo Soares	PSDB
Sétimo Waquim	PMDB
José de Ribamar Costa Alves	PSB
Roberto Coelho Rocha	PSDB
José Sarney Filho	PV
Sebastião Madeira	PSDB
Waldir Maranhão Cardoso	PP
Carlos Augusto Abicalil	PT
Victorio Galli Filho	PMDB
Eliene José de Lima	PP
Homero Alves Pereira	PR
Pedro Henry Neto	PP
Thelma Pimentel Figueiredo de Oliveira	PSDB
Valtenir Luís Pereira	PSB
Wellington Antônio Fagundes	PR
Antônio Carlos Biffi	PT
Antonio Ferreira da Cruz Filho	PP
Dagoberto Nogueira Filho	PDT
Geraldo Resende Pereira	PMDB
Marçal Gonçalves Leite Filho	PMDB
Nelson Trad	PMDB
Vander Luís dos Santos Loubet	PT
Waldemir Moka Miranda de Britto	PMDB
Ademir Camilo Prates Rodrigues	PDT
Aelton José de Freitas	PR
Alexandre Silveira de Oliveira	PPS
Antônio Eustáquio Andrade Ferreira	PMDB
Antônio Roberto Soares	PV
Aracely de Paula	PR
Olavo Bilac Pinto Neto	PR
Bonifácio José Tamm de Andrada	PSDB
Carlos Carmo Andrade Melles	DEM
Carlos Willian de Sousa	PTC
Ciro Francisco Pedrosa	PV
Edmar Batista Moreira	PR
Eduardo Luís Barros Barbosa	PSDB
Elismar Fernandes Prado	PT
Fábio Augusto Ramalho dos Santos	PV
Fernando Alberto Diniz	PMDB
George Hilton dos Santos Cecilio	PP
Geraldo Thadeu Pedreira dos Santos	PPS
Marcel Carvalho Santos	PTdoB
Gilmar Alves Machado	PT
Humberto Guimarães Souto	PPS
Jaime Martins Filho	PR
Jairo Ataide Vieira	DEM
Maria do Socorro Jô Moraes Vieira	PCdoB
João Bittar Júnior	DEM
João Lúcio Magalhães Bifano	PMDB
José Santana de Vasconcellos Moreira	PR
Julio Cesar Delgado	PSB
Silas Brasileiro	PMDB
Lael Vieira Varella	DEM
José Leonardo Costa Monteiro	PT
Leonardo Lemos Barros Quintão	PMDB
Lincoln Diniz Portela	PR
Luís Fernando Ramos Faria	PP
Marcio Reinaldo Dias Moreira	PP
Marcos Guimarães de Cerqueira Lima	PMDB
Marcos Montes Cordeiro	DEM
Maria Lúcia Cardoso	PMDB
Mario de Oliveira	PSC
Mário Lúcio Heringer	PDT
Mauro Ribeiro Lopes	PMDB
Miguel Correa da Silva Júnior	PT
José Miguel Martini	PHS
Narcio Rodrigues da Silveira	PSDB
Odair José da Cunha	PT
Paulo Abi-Ackel	PSDB
Paulo Piau Nogueira	PPS
José Rafael Guerra Pinto Coelho	PSDB
Reginaldo Lázaro de Oliveira Lopes	PT
Rodrigo Batista de Castro	PSDB
José Saraiva Felipe	PMDB
Virgílio Guimarães de Paula	PT
Vitor Penido de Barros	DEM
José Fernando Aparecido de Oliveira	PV
Asdrubal Mendes Bentes	PMDB
Ana Isabel Mesquita de Oliveira	PMDB
José Roberto Oliveira Faro	PT
Elcione Therezinha Zahluth Barbalho	PMDB
Gerson dos Santos Peres	PP
Giovanni Correa Queirós	PDT
Jader Fontenelle Barbalho	PMDB
Joaquim de Lira Maia	DEM
Lúcio Dutra Vale	PR
Nilson Pinto de Oliveira	PSDB
Paulo Roberto Galvão da Rocha	PT
Victor Pires Franco Neto	DEM
Wandenkolk Pasteur Gonçalves	PSDB
Wladimir Afonso da Costa Rabelo	PMDB
José Geraldo Torres da Silva	PT
Zenaldo Rodrigues Coutinho Junior	PSDB
José da Cruz Marinho	PMDB
Armando Abílio Vieira	PTB
Damião Feliciano da Silva	PDT
Efraim de Araújo Morais Filho	DEM
Luís Albuquerque Couto	PT
Manuel Alves da Silva Junior	PMDB
Marcondes Iran Benevides Gadelha	PSC
Rômulo José de Gouveia	PSDB
Fábio Rodrigues de Oliveira	DEM
Vital do Rego Filho	PMDB
José Wellington Roberto	PR
Wilson Leite Braga	PMDB
José Wilson Santiago	PMDB
Abelardo Luís Lupion Mello	DEM
Affonso Alves de Camargo Neto	PSDB
Airton Bernardo Roveda	PPS
Alceni Angelo Guerra	DEM
Alex Canziani Silveira	PTB
Jacob Alfredo Stoffels Kaefer	PSDB
André Luís Vargas Ilário	PT
Angelo Carlos Vanhoni	PT
Assis Miguel do Couto	PT
Wilson Picler	PDT
Cezar Augusto Carollo Silvestri	PPS
Francisco Octavio Beckert	PR
Dilceu João Sperafico	PP
Florisvaldo Fier	PT
Eduardo Francisco Sciarra	DEM
Fernando Lucio Giacobo	PR
Gustavo Bonato Fruet	PSDB
Hermes Parcianello	PMDB
Luís Carlos Jorge Hauly	PSDB
Luiz Carlos Setim	DEM
Max Rosenmann	PMDB
Moacir Micheletto	PMDB
Nelson Meurer	PP
Odílio Balbinotti	PMDB
Osmar José Serraglio	PMDB
Carlos Roberto Massa Junior	PSC
Marcelo Beltrão de Almeida	PMDB
Ricardo José Magalhães Barros	PP
Rodrigo Santos da Rocha Loures	PMDB
Hidekazu Takayama	PSC
Ana Lúcia Arraes de Alencar	PSB
André Carlos Alves de Paula Filho	DEM
Armando de Queirós Monteiro Neto	PTB
Bruno Cavalcanti de Araújo	PSDB
Bruno Campelo Rodrigues de Sousa	PSDB
Carlos Eduardo Cintra da Costa Pereira	PSC
Charles Lucena	PTB
Edgar Moury Fernandes Sobrinho	PMDB
Eduardo Henrique da Fonte de Albuquerque Silva	PP
Fernando Bezerra de Sousa Coelho Filho	PSB
Fernando Dantas Ferro	PT
Luís Gonzaga Patriota	PSB
Inocêncio Gomes de Oliveira	PR
Sílvio Serafim Costa	PMN
José Mendonça Bezerra	DEM
José Severiano Chaves	PTB
Marcos Antônio Ramos da Hora	PRB
Maurício Rands Coelho Barros	PT
Paulo Rubem Santiago Ferreira	PDT
Pedro Eugênio de Castro Toledo Cabral	PT
Raul Jean Louis Henry Júnior	PMDB
Raul Belens Jungmann Pinto	PPS
Renildo Vasconcelos Calheiros	PCdoB
Roberto Magalhães Melo	DEM
Wolney Queirós Maciel	PDT
Alberto Tavares Silva	PMDB
Benedito de Carvalho Sá	PSB
Átila Freitas Lira	PSDB
Ciro Nogueira Lima Filho	PP
Júlio César de Carvalho Lima	DEM
Marcelo Costa e Castro	PMDB
José de Andrade Maia Filho	DEM
José Nazareno Cardeal Fonteles	PT
Osmar Ribeiro de Almeida Júnior	PCdoB
José Francisco Paes Landim	PTB
Alexandre José dos Santos	PMDB
Andreia Almeida Zito dos Santos	PSDB
Arnaldo França Vianna	PDT
Ayrton Xerez	DEM
Bernardo Ramos Ariston	PMDB
Carlos Daudt Brizola	PDT
Carlos Augusto Alves Santana	PT
Francisco Rodrigues de Alencar Filho	PSOL
Francisco José D'Angelo Pinto	PT
Maria Aparecida Diogo Braga	PT
Wanderley Alves de Oliveira	PSC
Adilson Soares	PR
Edmilson José Valentim dos Santos	PCdoB
Edson Ezequiel de Matos	PMDB
Antônio Carlos Biscaia	PT
Eduardo Cosentino da Cunha	PMDB
Eduardo Benedito Lopes	PSB
Felipe Leone Bornier de Oliveira	PHS
Fernando Paulo Nagle Gabeira	PV
Fernando Lopes de Almeida	PMDB
Filipe de Almeida Pereira	PSC
Geraldo Roberto Siqueira de Sousa	PMDB
Hugo Leal Melo da Silva	PSC
Antônio Pedro de Siqueira Indio da Costa	DEM
Jair Messias Bolsonaro	PP
Glauber Braga	PSB
Leandro José Mendes Sampaio Fernandes	PPS
Iliobaldo Vivas da Silva	PRB
Leonardo Carneiro Monteiro Picciani	PMDB
Luís Sergio Nobrega de Oliveira	PT
Marcelo Zaturansky Nogueira Itagiba	PMDB
Marina Terra Maggessi de Sousa	PPS
Miro Teixeira	PDT
Neilton Mulim da Costa	PR
Nelson Roberto Bornier de Oliveira	PMDB
Otavio Santos Silva Leite	PSDB
Manuel Ferreira	PTB
Rodrigo Felinto Ibarra Epitácio Maia	DEM
Rogério Martins Lisboa	DEM
Paulo César da Guia Almeida	PR
Silvio Lopes Teixeira	PSDB
Simão Sessim	PP
Solange Pereira de Almeida	PMDB
Solange Amaral	DEM
Suely Santana da Silva	PR
Vinicius Rapozo de Carvalho	PTdoB
Fábio Salustino Mesquita de Faria	PMN
Maria de Fátima Bezerra	PT
Felipe Catalão Maia	DEM
Henrique Eduardo Lyra Alves	PMDB
João da Silva Maia	PR
Carlos Alberto Sousa Rosado	DEM
Rogério Simonetti Marinho	PSDB
Sandra Maria da Escóssia Rosado	PSB
Emília Teresinha Xavier Fernandes	PT
José Alfonso Ebert Hamm	PP
Luís Roberto de Albuquerque	PSB
Claudio Castanheira Diaz	PSDB
Darcisio Paulo Perondi	PMDB
Diógenes Luís Basegio	PDT
Eliseu Lemos Padilha	PMDB
Germano Mostardeiro Bonow	DEM
Henrique Fontana Junior	PT
Ibsen Valls Pinheiro	PMDB
José Otávio Germano	PP
Matteo Rota Chiarelli	DEM
Luciana Krebs Genro	PSOL
Luis Carlos Heinze	PP
Luís Carlos Ghiorzzi Busato	PTB
Manuela Pinto Vieira D'Ávila	PCdoB
Marco Aurélio Spall Maia	PT
Maria do Rosário Nunes	PT
Jorge Alberto Portanova Mendes Ribeiro Filho	PMDB
Onyx Dornelles Lorenzoni	DEM
Cézar Augusto Schirmer	PMDB
Paulo Pimenta	PT
Paulo Roberto Manoel Pereira	PTB
Gilberto José Spier Vargas	PT
Darci Pompeo de Mattos	PDT
Ruy Pauletti	PSDB
Renato Delmar Molling	PP
Sérgio Ivan Moraes	PTB
Tarcisio João Zimermmann	PT
Carlos Eduardo Vieira da Cunha	PDT
Vilson Luís Covatti	PP
Anselmo de Jesus Abreu	PT
Eduardo Valverde Araújo Alves	PT
Ernandes Santos Amorim	PTB
Lindomar Barbosa Alves	PV
Marinha Raupp	PMDB
Mauro Nazif Rasul	PSB
Rubens Moreira Mendes Filho	PPS
Natan Donadon	PMDB
Angela Maria Gomes Portela	PTC
Édio Vieira Lopes	PMDB
Francisco de Assis Rodrigues	DEM
Luciano de Sousa Castro	PR
Márcio Henrique Junqueira Pereira	DEM
Maria Helena Veronese Rodrigues	PSB
Neudo Ribeiro Campos	PP
Urzeni da Rocha Freitas Filho	PSDB
Angela Regina Heinzen Amin Helou	PP
Carlito Merss	PT
Celso Maldaner	PMDB
Décio Nery de Lima	PT
Djalma Vando Berger	PSDB
Edson Bez de Oliveira	PMDB
Carlos Fernando Coruja Agustini	PPS
Gervásio José da Silva	PSDB
João Batista Matos	PMDB
João Alberto Pizzolatti Júnior	PP
José Carlos Vieira	DEM
Nelson Goetten de Lima	PR
Paulo Roberto Barreto Bornhausen	DEM
Valdir Colatto	PMDB
Cláudio Antônio Vignatti	PT
Odacir Zonta	PP
José Abelardo Guimarães Camarinha	PSB
José Aldo Rebelo Figueiredo	PCdoB
Aline Lemos Correia de Oliveira Andrade	PP
Antônio Carlos Martins de Bulhões	PMDB
Antônio Carlos de Mendes Thame	PSDB
Antonio Carlos Pannunzio	PSDB
Antonio Palocci Filho	PT
Arlindo Chinaglia Júnior	PT
Arnaldo Faria de Sá	PTB
Arnaldo Calil Pereira Jardim	PPS
Arnaldo de Abreu Madeira	PSDB
Paulo Roberto Gomes Mansur	PP
Carlos Henrique Focesi Sampaio	PSDB
Carlos Alberto Rolim Zarattini	PT
Celso Ubirajara Russomanno	PP
Cláudio Magrão de Camargo Cre	PPS
Jairo Paes Lira	PTC
Devanir Ribeiro	PT
Sergio Antônio Nechar	PV
Talmir Rodrigues	PV
Marco Aurélio Ubiali	PSB
Antônio Duarte Nogueira Júnior	PSDB
Edson Aparecido dos Santos	PSDB
Emanuel Fernandes	PSDB
Luciana Castro de Almeida	PR
Fernando Barrancos Chucre	PSDB
Francisco Rossi de Almeida	PMDB
Francineto Luz de Aguiar	PTB
Guilherme Campos Junior	DEM
Ivan Valente	PSOL
Janete Rocha Pietá	PT
Jilmar Augustinho Tatto	PT
João Eduardo Dado Leite de Carvalho	PDT
Fernando Chiarelli	PDT
João Paulo Cunha	PT
Jorge Tadeu Mudalen	DEM
Jorge de Faria Maluly	DEM
José Aníbal Peres de Pontes	PSDB
José Eduardo Martins Cardozo	PT
José Genoíno Neto	PT
José Mentor Guilherme de Melo Neto	PT
José Paulo Toffano	PV
Júlio Francisco Semeghini Neto	PSDB
Antônio Adolfo Lobbe Neto	PSDB
Luíza Erundina de Sousa	PSB
Francisco Marcelo Ortiz Filho	PV
Márcio Luís França Gomes	PSB
Michel Miguel Elias Temer Lulia	PMDB
Milton Antônio Casquel Monti	PR
Nelson Marquezelli	PTB
Paulo Pereira da Silva	PDT
Paulo Salim Maluf	PP
Paulo Renato Costa Sousa	PSDB
Luís Paulo Teixeira Ferreira	PT
Régis Fernandes de Oliveira	PSC
Reinaldo Nogueira Lopes Cruz	PDT
Renato Fauvel Amary	PSDB
Ricardo José Ribeiro Berzoini	PT
Jefferson Alves de Campos	PTB
José Ricardo Alvarenga Tripoli	PSDB
José Roberto Santiago Gomes	PV
Sílvio Roberto Cavalcanti Peccioli	DEM
Sílvio França Torres	PSDB
Cândido Elpídio de Sousa Vaccarezza	PT
Etivaldo Vadão Gomes	PP
Valdemar Costa Neto	PR
Vanderlei Macris	PSDB
Vicente Paulo da Silva	PT
Walter Shindi Iihoshi	DEM
William Boss Woo	PSDB
Ciro Ferreira Gomes	PSB
Albano do Prado Pimentel Franco	PSDB
Eduardo Alves do Amorim	PSC
José Iran Barbosa Filho	PT
Jackson Barreto de Lima	PMDB
Jerônimo de Oliveira Reis	DEM
José Carlos Machado	DEM
José de Araújo Mendonça Sobrinho	DEM
Antônio Carlos Valadares Filho	PSB
Carlos Eduardo Torres Gomes	PSDB
João Oliveira de Sousa	DEM
Laurez da Rocha Moreira	PSB
Lázaro Botelho Martins	PP
Moisés Nogueira Avelino	PMDB
Nilmar Gavino Ruiz	DEM
Osvaldo de Sousa Reis	PMDB
Vicente Alves de Oliveira	PR